start,1,8,,,,,,,
goal,7,7,,,,,,,
f,f,f,f,f,c,c,c,c,c
f,a,a,a,f,c,c,f,f,f
f,a,b,a,f,c,c,f,b,f
f,a,a,a,f,c,c,f,f,f
f,f,f,f,f,c,c,c,c,c
c,c,c,c,c,c,c,c,c,c
c,c,c,c,c,f,f,f,f,f
c,c,c,c,c,f,b,b,b,f
c,c,c,c,c,f,b,a,b,f
c,c,c,c,c,f,b,b,b,f
c,c,c,c,c,f,f,f,f,f