start,1,8,,,,,,,
goal,7,7,,,,,,,
{},{},{},{},{},{},{},{},{},{}
{},a,a,a,a,{},{},{},{},{}
{},a,b,b,a,{},{},{},{},{}
{},a,b,b,a,{},{},{},{},{}
{},a,a,a,a,{},{},{},{},{}
{},{},{},{},{},{},{},{},{},{}
{},{},{},{},{},a,a,a,a,{}
{},{},{},{},{},a,c,c,a,{}
{},{},{},{},{},a,c,c,a,{}
{},{},{},{},{},a,a,a,a,{}
{},{},{},{},{},{},{},{},{},{}