start,1,8,,,,,,,
goal,7,7,,,,,,,
f,f,f,f,f,{},{},{},{},{}
f,a,a,a,f,{},{},{},{},{}
f,a,b,a,f,{},{},{},{},{}
f,a,a,a,f,{},{},{},{},{}
f,f,f,f,f,{},{},{},{},{}
{},{},{},{},{},{},{},{},{},{}
{},{},{},{},{},f,f,f,f,f
{},{},{},{},{},f,b,b,b,f
{},{},{},{},{},f,b,a,b,f
{},{},{},{},{},f,b,b,b,f
{},{},{},{},{},f,f,f,f,f