start,1,8,,,,,,,
goal,7,7,,,,,,,
{},{},{},{},{},{},{},{},{},{}
{},{},{},{},{},{},{},{},ad,{}
{},{},{},{},{},ae,{},{},{},{}
{},{},be,{},{},{},{},{},{},{}
{},{},{},{},{},{},{},{},{},{}
{},{},{},{},{},{},{},{},{},{}
{},{},{},{},{},{},{},ce,{},{}
{},{},{},{},cd,{},{},{},{},{}
{},{},bd,{},{},{},{},{},{},{}
{},{},{},{},{},{},{},{},{},{}
{},{},{},{},{},{},{},{},{},{}