start,1,8,,,,,,,
goal,7,7,,,,,,,
c,c,c,c,c,d,d,d,d,d
c,a,a,a,c,d,d,c,c,c
c,a,b,a,c,d,d,c,b,c
c,a,a,a,c,d,d,c,c,c
c,c,c,c,c,d,d,d,d,d
d,d,d,d,d,d,d,d,d,d
d,d,d,d,d,c,c,c,c,c
d,d,d,d,d,c,b,b,b,c
d,d,d,d,d,c,b,a,b,c
d,d,d,d,d,c,b,b,b,c
d,d,d,d,d,c,c,c,c,c