start,1,8,,,,,,,
goal,7,7,,,,,,,
{},{},{},a,a,a,{},{},{},{}
{},{},{},a,a,a,{},{},{},{}
{},{},{},a,a,a,{},{},{},{}
{},{},{},a,a,a,{},{},{},{}
{},c,{},a,a,a,{},{},{},{}
{},{},{},#,#,#,{},{},{},{}
{},{},{},b,b,b,{},{},{},{}
{},{},{},b,b,b,{},{},{},{}
{},{},{},b,b,b,{},{},{},{}
{},{},{},b,b,b,{},{},{},{}
{},{},{},b,b,b,{},{},{},{}