start,1,8,,,,,,,
goal,7,7,,,,,,,
c,c,c,c,c,{},{},{},{},{}
c,a,a,a,c,{},{},{},{},{}
c,a,b,a,c,{},{},{},{},{}
c,a,a,a,c,{},{},{},{},{}
c,c,c,c,c,{},{},{},{},{}
{},{},{},{},{},{},{},{},{},{}
{},{},{},{},{},c,c,c,c,c
{},{},{},{},{},c,b,b,b,c
{},{},{},{},{},c,b,a,b,c
{},{},{},{},{},c,b,b,b,c
{},{},{},{},{},c,c,c,c,c