start,1,8,,,,,,,
goal,7,7,,,,,,,
0,0,0,a,a,a,0,0,0,0
0,0,0,a,a,a,0,0,0,0
0,0,0,a,a,a,0,0,0,0
0,0,0,a,a,a,0,0,0,0
0,c,0,a,a,a,0,0,0,0
0,0,0,b,b,b,0,0,0,0
0,0,0,b,b,b,0,0,0,0
0,0,0,b,b,b,0,0,0,0
0,0,0,b,b,b,0,0,0,0
0,0,0,b,b,b,0,0,0,0
0,0,0,b,b,b,0,0,0,0