start,1,8,,,,,,,
goal,7,7,,,,,,,
#,#,#,#,#,#,#,#,#,#
#,{},{},{},{},{},{},{},{},#
#,{},{},{},{},bd,be,ad,{},#
#,{},{},{},{},#,cd,{},{},#
#,{},{},{},#,#,{},{},{},#
#,{},{},#,#,{},{},{},{},#
#,{},{},{},#,{},{},{},{},#
#,{},{},{},{},{},{},{},{},#
#,{},{},{},{},{},{},{},{},#
#,#,#,#,#,#,#,#,#,#