start,1,8,,,,,,,
goal,7,7,,,,,,,
0,0,0,0,0,0,0,0,0,0
0,1,1,1,1,0,0,0,0,0
0,1,2,2,1,0,0,0,0,0
0,1,2,2,1,0,0,0,0,0
0,1,1,1,1,0,0,0,0,0
0,0,0,0,0,0,0,0,0,0
0,0,0,0,0,1,1,1,1,0
0,0,0,0,0,1,4,4,1,0
0,0,0,0,0,1,4,4,1,0
0,0,0,0,0,1,1,1,1,0
0,0,0,0,0,0,0,0,0,0