start,1,8,,,,,,,
goal,7,7,,,,,,,
0,0,0,0,0,0,0,0,0,0
0,a,a,a,a,0,0,0,0,0
0,a,b,b,a,0,0,0,0,0
0,a,b,b,a,0,0,c,0,0
0,a,a,a,a,0,0,0,0,0
0,0,0,0,0,0,0,0,0,0
0,0,0,0,0,a,a,a,a,0
0,0,0,0,0,a,ab,ab,a,0
0,0,0,0,0,a,ab,ab,a,0
0,0,0,0,0,a,a,a,a,0
0,0,0,0,0,0,0,0,0,0